# Segment 27 — 40 grid-cols × 64 grid-rows
# bbox: cols [0, 39] × rows [0, 63]

·000~000000~00000{000000100000z0000000000000{000····D···········
00000y~~~~{0y~~~{0000000000000700000000000080000················
000000000000000000000000000000y~~~0000~~000{0000················
0000000 00000000000000·w0x00000000y~~{00y~{00000················
000000000000000000}}}w0000x}}0000000000000000000················
000000000000}}}}}w00000000000x}}}000000000000000················
}}}}}}}}}}}w000000000000000000000x}}}}}}}0000000················
00000000000000000000000000000000000000000x}}}}00················
0000000000000000000000000000000000000000000000x}················
000000000000000000000000000000000000000000000000················
000000000000000000000000000000000000000000000000················
000000000000000000000000000000000000000000000000················
000000000000000000000000000000000000000000000000················
000000000000000000000000000000000000000000000000················
000000000000000000000000000000000000000000000000················
000000000000000000000000000000000000000000000000················
000000000000000000000000000000000000000000000000················
000000000000000000000000000000000000000000000000················
000000000000000000000000000000000000000000000000················
000000000000000000000000000000000000000000000000················
000000000000000000000000000000000000000000000000················
000000000000000000000000000000000000000000000000················
000000000000000000000000000000000000000000000000················
000000000000000000000000000000000000000000000000················
00000000000000000000000d0e0000000000000000000000················
0000000000000000000000d0e00000000000000000000000················
000000000000000000000d0e000000000000000000000000················
00000000000000000000d0e0000000000000000000000000················
·000000000000000000d0e00000000000000000000000000················
000000000000000000d0e000000000000000000000090000················
00000000000000000d0e00000000000000000000000hhh00················
0000000000000000d00000000000000000000000000hhh00················
000000000000000d0e0000000000000000000000000hhh00················
00000000000000d0e0000000000000000000000000000000················
0000000000000d0e00000000000000000000000000000000················
000000000000d0e000000000000000000000000000000000················
00000000000d0e0000000000000000000000000000000000················
0000000000d0e00000000000000000000000000000000000················
00000000000e000000000000000000000000000000000000················
000000000ggg000000000000000000000000000000000000················