# Segment 30 — 40 grid-cols × 64 grid-rows
# bbox: cols [0, 39] × rows [0, 63]

 9999999999989999999999900000000000000000000000A0000000000000000
00000000000000000000000000000000000000000000000A0000000000000000
00000000000009000000000000000000000000000000000A0000000000000000
00000000000090900000000000000000000000000000000A0000000000000000
00000000000009090000000000000000000000000000000A0000000000000000
00000000000000909000000000000000000000000000000A0000000000000000
00000000000000090900000000000000000000000000000A0000000000000000
00000000000000009090000000000000000000000000000A0000000000000000
00000000000000000900000000000000000000000000000A0000000000000000
00000000000000000000000000000000000000000000000A0000000000000000
00000000000000000900000000000000000000000000000A0000000000000000
00000000000000009090000000000000000000000000000A0000000000000000
00000000000000090900000000000000000000000000000w0000000000000000
0000000000000090900000000000000000000000000000A00000000000000000
0000000000000909000000000000000000000000000000A00000000000000000
0000000000009090000000000000000000000000000000w00000000000000000
000000000009090000000000000000000000000000000A000000000000000000
000000000090900000000000000000000000000000000A000000000000000000
000000000909000000000000000000000000000000000w000000000000000000
00000000909000000000000000000000000000000000A0000000000000000000
00000009090000000000000000000000000000000000w0000000000000000000
0000009090000000000000000000000000000000000A00000000000000000000
0000090900000000000000000000000000000000000w00000000000000000000
000000900000000000000000000000000000000000w000000000000000000000
0000000000000000000000000000000000000000}w0000000000000000000000
x0000090000000000000000000000000000000}w000000000000000000000000
090009090000000000000000000000000000}w00000000000000000000000000
0x00009090000000000000000000000000}w0000000000000000000000000000
·0x}000909000000000000000000000}}w000000000000000000000000000000
0000x}0090900000000000000000}}w000000000000000000000000000000000
000000x}}909}}}}}}}}}}}}}}}w000000000000000000000000000000000000
0000000000c0b000000000000000000000000000000000000000000000000000
00000000000c0000000000000000000000000000000000000000000000000000
0000000000000000000000000000000000000000000000000000000000000000
0000000000000000000000000000000000000000000000000000000000000000
0000000000000000000000000000000000000000000000000000000000000000
0000000000000000000000000000000000000000000000000000000000000000
0000000000000000000000000000000000000000000000000000000000000000
0000000000000000000000000000000000000000000000000000000000000000
0088888888888888888888800000000000000000000000000000000000000000